0000000000
0003000300
0011111110
1020400200
0000000000
1000200000
0000000000
1000000005
0000000000
1111111111