3000000003
0011111100
0040000000
0000000111
3000000003
0011111100 
0000200000
1111000000
5000220000
1111111111