5300400035
1100000011
0020000000
0011111100
2000500002
1100000011 
0002220000
0011111100
0003230000
1111111111